+---+-------+-------------------------------------+
|   |       |   #####       |         |       |   |
| | +-+ +-+ +---------+ +-+ | +-----+ --- ----+   |
| |   | | |           | | |   |     |     |   |   |
| +-+ | | +--###----+ | | +---+ ----+-----+-- +-- |
| | |   |           | | | ##  |       |       | | |
| | +---+ --+ +-----+ | | | --+ +-- +-+ +-+ | + | |
| |         | |       | | |     |   |   | | |   | |
| | +-----+ +-+ --+---+ +-+-+ --+ --+ --+ | +-+ | |
| | |     |   |   |     |   |   |         | | | | |
| +-+ +-- +-- +-+ +-+ --+ | +-- +---------+ | | | |
| |   |       | |   |  A  | |   | |       | |   | |
| | --+-+-#-+ | +-+ +-+ --+ +-+ | | +---- | | +-+ |
| |    #|   | |   |   |   |   |   | |     | | |   |
| | | ##| --+ +-+ +-+ +---+-- +-- | +-+ --+ | | +-|
| | |## |    #  |   | |  ###  |   |   |     | | | |
| | |#  +---+-- | | | | +-#---+ --+-+ +-----+ | | |
| | |#      |   | | |   |     |   | |       ##|   |
| +-+-----+ | --+ ------+ ----+-+ | +---+ | ##+-+ |
| |#      | |     |     |       |   |   | | ##  | |
| | +---- | +-----+ | --+ +---- +-- | + +-+#----+ |
|###|     |         |  ###|## |     | |   |###### |
| --+ ----+----------------#| +-----+ +-+ |#    # |
|   |                 ######|##         |    ##   |
+-------------------------------------------------+
